11111111111
10000000001
10500800501
10000000001
11111111111
10000000001
10000900001
10000000001
11111111111
