1111111111
1800000001
1010111101
1010111101
1010007101
1010110101
1010110191
1010110101
1800002003
1111111111