1111111111
1010000001
1010000001
1010000001
1011100001
1000000001
1000001111
1000000001
1000000001
1111111111
