1111111111
1000000051
1080000001
1009000111
1000000001
1000110701
1000100001
1060100601
1000100001
1111111111