1111111111
1000000001
1000000001
1000000001
1110111111
1000000001
1000000001
1000000001
1111111101
1111111111
