1111111111
1300000001
1000000001
1000000001
1112111111
1300000001
1000000001
1000033121
1111111101
1111111111
