1111111111
1000000001
1000000001
1000000001
1112111111
1000000001
1000000001
1000000121
1111111101
1111111111
