11111111111
10000800001
10000000001
10000000001
10000000001
10500000501
10000000001
11111111111
10000900001
10000000001
11111111111
